........#######......................
........#.....#......................
........#.....#......................
........#.....#......................
#########.#########..................
#.........#...#...#..................
#...###########...#..................
#...#.....#.......#..................
#...#.....#.......#.#####.#######....
#...#.....#.......#.#...#.#.....#....
###########.......#.#...#.#.....#....
....#.............#.#...#.#.....#....
....#.............#.###########.#....
....#.............#.....#.#.....#....
....#######.......#######.#.....#....
..........#...............#.....#....
..........#...............#.....####^
..........#...............#..........
..........#.#######.......#######....
..........#.#.....#.............#....
......###########.#.............#....
......#...#.#...#.#.............#....
......#...#.#...#.#.......###########
......#...#.#...#.#.......#.....#...#
......#####.#####.#.......#.....#...#
..................#.......#.....#...#
..................#...###########...#
..................#...#...#.........#
..................#########.#########
......................#.....#........
......................#.....#........
......................#.....#........
......................#######........